     111111
     1000011
     1000001
111111000001
100000000001
111111111111