111111
101111
100001
101001
1000N1
111111