111111
101
100001
101001
1000N1
111111