    NO sciana.xpm



WE stone_bricks.xpm
EA photo64x64.xpm

SO sciana.xpm

F 255,0,0
 C 255,255,255


1111111111111111111111111111111111111111111111111111111111111111111
1110011111111111111111111111111111111111111111111111111111111111111
1000000000001000000000000000000000000000000000000000000000000000001
1000000000001000000000000000000000000000000000000000000000000000001
1000000000001000000000000000000000000000000000000000000000000000001
100000S000000000000000000010000000000000000000000000000000000000001
1000000000000000001000000010000000000000000000000000000000000000001
1000000000000000000000000010000000000000000000000000000000000000001
1000000000000000000000000010000000000000000000000000000000000000001
1111111111111111111111111111111111111111111111111111111111111111111