    NO ./path_to_the_north_texture




WE ./path_to_the_west_texture
EA ./path_to_the_east_texture

SO ./path_to_the_south_texture

F 220  ,  100  ,  0
 C 225,30,0


    11111
   111111
111111
10000011
11N000111
11110001
   1111 
11111111