     111111
     1000011
     1000001
11111100 001
10000E100011
11111111111