    NO scianaa.xpm



WE stone_bricks.xpm
EA photo64x64.xpm

SO scianaa.xpm

F 0, 100,    100
 C 125  ,50,30


1111111111111111111111111111111111111111111111111111111111111111111
1110011111111111111111111111111111111011111111111111111111111111111
1000000100001000000000000000000000000000000000000000000000000000001
101110N100001000000000000000000000000000000000000000000000000000001
1010011100001000000000000000000000000100000000000000000001111111111
1000000000000000000000000010000000000000000000000000000001
1111000000000000001000000010000000000000011100000000000001111111111
   1000000000000000000000010000000000000011100000000000000000000001
1111000000000000000000000010000000000000011100000000000000000111111
11111111111111111111111111111111111111111111111111111111111111
