    NO ddiana.xpm


WE stone_bricks.xpm


EA stbricks.xpm

SO sciana.xpm

F 0, 100,    100
 C 125  ,50,30

11111
10001
1N001
10001
11111