    NO ./path_to_the_north_texture




WE ./path_to_the_west_texture
EA ./path_to_the_east_texture

SO ./path_to_the_south_texture

F 220  ,  100  ,  0
 C 225,30,0


1111111111
1 00000011
1100010011
 1N0000111
1111111111
