     111111
     1000011
     100N001
11111100 001
10000E100011
11111111111