    11111
   111111
111111
10000011
00N000111
11110001
   1111 
11101111