     111111
     1000011
     100001
11111100 001
     100E0011
11111111111