    11111
   111111
111111
10000011
11N000111
11110001
   1111 
111 1111