    11111
   111111
111111
10000011
11N000111
11110000
   1111 
11101111