    NO wall1.xpm


WE wall_colors.xpm


EA wall_bricks.xpm

SO wall2.xpm

F 0, 100,    100
 C 125  ,50,30



1111
1N11
1111




