   NO wall1.xpm


WE wall_colors.xpm


EA wall_bricks.xpm

SO wall2.xpm

F 0, 100,    100
 C 125  ,50,30

  11111
  111111
   110001 
  100E1 1 
  1111111
  111111 1