    NO wall1.xpm


WE wall_colors.xpm


EA wall_bricks.xpm

SO wall2.xpm

F 0, 100,    100
 C 125  ,50,30



1111111111
1 00000011
1100010011
 1N0000111
11111111


